26 11 2
##########################
#                        #
#      $ ##########      #
#        #               #
#        #               #
#    .   #  @  $         #
#        #               #
#        #               #
#      $        .        #
#                        #
##########################
