12 6 0
############
#          #
#  #       #
# #        #
#   #      #
############
