18 10 2
##################
#                #
#                #
#   .  $ #@      #
#     #          #
#     #          #
#     #          #
#       $        #
#    .           #
##################
