10 5 1
##########
#        #
#  @$  . #
#        #
##########
