23 10 1
#######################
#                     #
#     ####            #
#     #  @ ##         #
#     #   $##.#       #
#     #    ##         #
#                     #
#                     #
#                     #
#######################
