15 7 1
###############
#             #
#   #  @  $ . #
#   #     #   #
#   #  #      #
#             #
###############
